LOOK	L UH K
IF	IH F
YOU	Y UW
HAD	HH AE D
ONE	W AH N
ONE(2)	HH W AH N
SHOT	SH AA T
OR	AO R
OR(2)	ER
OPPORTUNITY	AA P ER T UW N AH T IY
TO	T UW
TO(2)	T IH
TO(3)	T AH
SEIZE	S IY Z
EVERYTHING	EH V R IY TH IH NG
EVER	EH V ER
WANTED	W AO N T IH D
IN	IH N
MOMENT	M OW M AH N T
WOULD	W UH D
CAPTURE	K AE P CH ER
IT	IH T
JUST	JH AH S T
JUST(2)	JH IH S T
LET	L EH T
SLIP	S L IH P
YO	Y OW
HIS	HH IH Z
PALMS	P AA M Z
PALMS(2)	P AA L M Z
ARE	AA R
ARE(2)	ER
SWEATY	S W EH T IY
KNEES	N IY Z
WEAK	W IY K
ARMS	AA R M Z
HEAVY	HH EH V IY
THERE'S	DH EH R Z
VOMIT	V AA M AH T
ON	AA N
ON(2)	AO N
SWEATER	S W EH T ER
ALREADY	AO L R EH D IY
ALREADY(2)	AO R EH D IY
MOM'S	M AA M Z
SPAGHETTI	S P AH G EH T IY
HE'S	HH IY Z
NERVOUS	N ER V AH S
BUT	B AH T
THE	DH AH
THE(2)	DH IY
SURFACE	S ER F AH S
HE	HH IY
LOOKS	L UH K S
CALM	K AA M
CALM(2)	K AA L M
AND	AH N D
AND(2)	AE N D
READY	R EH D IY
DROP	D R AA P
DROP(2)	D R AO P
BOMBS	B AA M Z
KEEPS	K IY P S
FORGETTING	F ER G EH T IH NG
FORGETTING(2)	F AO R G EH T IH NG
WHAT	W AH T
WHAT(2)	HH W AH T
WROTE	R OW T
DOWN	D AW N
WHOLE	HH OW L
CROWD	K R AW D
GOES	G OW Z
SO	S OW
LOUD	L AW D
OPENS	OW P AH N Z
MOUTH	M AW TH
WORDS	W ER D Z
WON'T	W OW N T
COME	K AH M
OUT	AW T
CHOKING	CH OW K IH NG
HOW	HH AW
EVERYBODY'S	EH V R IY B AA D IY Z
JOKING	JH OW K IH NG
NOW	N AW
CLOCK'S	K L AA K S
RUN	R AH N
TIME'S	T AY M Z
UP	AH P
OVER	OW V ER
BLOAH	B L OW AH
SNAP	S N AE P
BACK	B AE K
REALITY	R IY AE L AH T IY
OH	OW
THERE	DH EH R
GRAVITY	G R AE V AH T IY
GRAVITY(2)	G R AE V IH T IY
RABBIT	R AE B AH T
RABBIT(2)	R AE B IH T
CHOKED	CH OW K T
MAD	M AE D
GIVE	G IH V
THAT	DH AE T
THAT(2)	DH AH T
EASY	IY Z IY
NO	N OW
HAVE	HH AE V
KNOWS	N OW Z
BACK'S	B AE K S
THESE	DH IY Z
ROPES	R OW P S
DON'T	D OW N T
DON'T(2)	D OW N
MATTER	M AE T ER
DOPE	D OW P
BROKE	B R OW K
STAGNANT	S T AE G N AH N T
WHEN	W EH N
WHEN(2)	HH W EH N
WHEN(3)	W IH N
WHEN(4)	HH W IH N
MOBILE	M OW B AH L
HOME	HH OW M
THAT'S	DH AE T S
IT'S	IH T S
LAB	L AE B
AGAIN	AH G EH N
AGAIN(2)	AH G EY N
THIS	DH IH S
RHAPSODY	R AE P S AH D IY
BETTER	B EH T ER
GO	G OW
HOPE	HH OW P
PASS	P AE S
HIM	HH IH M
HIM(2)	IH M
LOSE	L UW Z
YOURSELF	Y ER S EH L F
YOURSELF(2)	Y UH R S EH L F
YOURSELF(3)	Y AO R S EH L F
MUSIC	M Y UW Z IH K
OWN	OW N
NEVER	N EH V ER
ONLY	OW N L IY
GET	G EH T
GET(2)	G IH T
DO	D UW
NOT	N AA T
MISS	M IH S
YOUR	Y AO R
YOUR(2)	Y UH R
CHANCE	CH AE N S
BLOW	B L OW
COMES	K AH M Z
ONCE	W AH N S
A	AH
A(2)	EY
LIFETIME	L AY F T AY M
SOUL'S	S OW L Z
ESCAPING	IH S K EY P IH NG
THROUGH	TH R UW
HOLE	HH OW L
GAPING	G EY P IH NG
WORLD	W ER L D
IS	IH Z
MINE	M AY N
FOR	F AO R
FOR(2)	F ER
FOR(3)	F R ER
TAKING	T EY K IH NG
MAKE	M EY K
ME	M IY
KING	K IH NG
AS	AE Z
AS(2)	EH Z
WE	W IY
MOVE	M UW V
TOWARD	T AH W AO R D
TOWARD(2)	T AO R D
NEW	N UW
NEW(2)	N Y UW
ORDER	AO R D ER
NORMAL	N AO R M AH L
LIFE	L AY F
BORIN	B AO R IH N
SUPERSTARDOM'S	S UW P ER S T AA R D AH M Z
CLOSE	K L OW S
CLOSE(2)	K L OW Z
POST	P OW S T
MORTAR	M AO R T ER
GROWS	G R OW Z
HARDER	HH AA R D ER
HOTTER	HH AA T ER
BLOWS	B L OW Z
US	AH S
US(2)	Y UW EH S
ALL	AO L
HOES	HH OW Z
COAST	K OW S T
SHOWS	SH OW Z
KNOW	N OW
GLOBETROTTER	G L OW B T R AO T ER
LONELY	L OW N L IY
ROADS	R OW D Z
GOD	G AA D
GROWN	G R OW N
FARTHER	F AA R DH ER
FROM	F R AH M
FATHER	F AA DH ER
BARELY	B EH R L IY
DAUGHTER	D AO T ER
HOLD	HH OW L D
NOSE	N OW Z
CUZ	K AH Z
HERE	HH IY R
COLD	K OW L D
WATER	W AO T ER
WANT	W AA N T
WANT(2)	W AO N T
MO	M OW
PRODUCT	P R AA D AH K T
THEY	DH EY
MOVED	M UW V D
NEXT	N EH K S T
NEXT(2)	N EH K S
SCHMOE	S K M OW
WHO	HH UW
FLOWS	F L OW Z
DOVE	D AH V
DOVE(2)	D OW V
SOLD	S OW L D
NADA	N AA D AA
SOAP	S OW P
OPERA	AA P R AH
TOLD	T OW L D
UNFOLDS	AH N F OW L D Z
I	AY
SUPPOSE	S AH P OW Z
OLD	OW L D
POTNA	P AA T N AH
BEAT	B IY T
DA	D AA
DA(2)	D IY EY
DUM	D AH M
MORE	M AO R
GAMES	G EY M Z
I'MA	IH M AH
CHANGE	CH EY N JH
CALL	K AO L
RAGE	R EY JH
TEAR	T EH R
TEAR(2)	T IH R
MOTHAFUCKIN	M AO TH AH F AH K IH N
ROOF	R UW F
ROOF(2)	R UH F
OFF	AO F
LIKE	L AY K
2	T UW
DOGS	D AA G Z
DOGS(2)	D AO G Z
CAGED	K EY JH D
WAS	W AA Z
PLAYIN	P L EY IH N
BEGINNIN	B EH G IH N IH N
MOOD	M UW D
CHANGED	CH EY N JH D
BEEN	B IH N
BEEN(2)	B AH N
CHEWED	CH UW D
SPIT	S P IH T
BOOED	B UW D
STAGE	S T EY JH
KEPT	K EH P T
KEPT(2)	K AE P T
RHYMIN	R IH M AH N
STEPWRITIN	S T EH P R IH T IH N
CYPHER	S AY F ER
BEST	B EH S T
BELIEVE	B IH L IY V
SOMEBODY'S	S AH M B AA D IY Z
PAYIN	P EY IH N
PIED	P AY D
PIPER	P AY P ER
PAIN	P EY N
INSIDE	IH N S AY D
AMPLIFIED	AE M P L AH F AY D
BY	B AY
FACT	F AE K T
CAN'T	K AE N T
WITH	W IH DH
WITH(2)	W IH TH
MY	M AY
9	N AY N
5	F AY V
PROVIDE	P R AH V AY D
RIGHT	R AY T
TYPE	T AY P
OF	AH V
FAMILY	F AE M AH L IY
FAMILY(2)	F AE M L IY
MAN	M AE N
GODDAM	G AA D D AE M
FOOD	F UW D
STAMPS	S T AE M P S
BUY	B AY
DIAPERS	D AY AH P ER Z
DIAPERS(2)	D AY P ER Z
MOVIE	M UW V IY
MEKHI	M EH K IY
PHIFER	F AY F ER
TIMES	T AY M Z
HARD	HH AA R D
GETTING	G EH T IH NG
GETTING(2)	G IH T IH NG
EVEN	IY V IH N
TRYIN	T R AY IH N
FEED	F IY D
SEED	S IY D
PLUS	P L AH S
TEETER-TOTTER	T IY T ER T AA T ER
CAUGHT	K AA T
CAUGHT(2)	K AO T
BETWEEN	B IH T W IY N
BETWEEN(2)	B IY T W IY N
BEIN	B IY N
PRIMA	P R IY M AH
DONNA	D AA N AH
BABY	B EY B IY
MAMA	M AA M AH
DRAMA'S	D R AA M AH Z
SCREAMIN	S K R IY M IH N
TOO	T UW
MUCH	M AH CH
WANNA	W AA N AH
STAY	S T EY
SPOT	S P AA T
ANOTHER	AH N AH DH ER
DAY'S	D EY Z
MONOTONY	M AH N AA T AH N IY
HAS	HH AE Z
HAS(2)	HH AH Z
GOTTEN	G AA T AH N
GOTTEN(2)	G AO T AH N
POINT	P OY N T
I'M	AY M
I'M(2)	AH M
SNAIL	S N EY L
I'VE	AY V
GOT	G AA T
FORMULATE	F AO R M Y AH L EY T
PLOT	P L AA T
END	EH N D
JAIL	JH EY L
SUCCESS	S AH K S EH S
OPTION	AA P SH AH N
OPTION(2)	AO P SH AH N
FAILURE'S	F EY L Y ER Z
MOM	M AA M
LOVE	L AH V
TRAIL	T R EY L
CANNOT	K AE N AA T
CANNOT(2)	K AH N AA T
GROW	G R OW
SALEM'S	S EY L AH M Z
LOT	L AA T
LOT(2)	L AO T
FEET	F IY T
FAIL	F EY L
MAY	M EY
BE	B IY
CAN	K AE N
CAN(2)	K AH N
ANYTHING	EH N IY TH IH NG
SET	S EH T
MIND	M AY N D
TOUCH	T AH CH
FEEL	F IY L
RUSH	R AH SH
CLUTCH	K L AH CH
ISN'T	IH Z AH N T
ISN'T(2)	IH Z AH N
ENOUGH	IH N AH F
ENOUGH(2)	IY N AH F
WONDER	W AH N D ER
WHAT'S	W AH T S
WHAT'S(2)	HH W AH T S
STORE	S T AO R
LUST	L AH S T
TORTUROUS	T AO R CH UW AH S
MUST	M AH S T
SORCERESS	S AO R S AH R AH S
'CAUSE	K AH Z
DID	D IH D
IMPOSSIBLE	IH M P AA S AH B AH L
GAINED	G EY N D
TRUST	T R AH S T
PLAY	P L EY
IT'LL	IH T AH L
IT'LL(2)	IH T L
DANGEROUS	D EY N JH ER AH S
FUCK	F AH K
BURNT	B ER N T
SHOW	SH OW
HURT	HH ER T
TREATED	T R IY T AH D
TREATED(2)	T R IY T IH D
DIRT	D ER T
BEFORE	B IH F AO R
BEFORE(2)	B IY F AO R
YA'	Y AA
'EVOL'	EH V AH L
SPELL	S P EH L
BACKWARDS	B AE K W ER D Z
I'LL	AY L
YA	Y AA
NOBODY	N OW B AA D IY
NOBODY(2)	N OW B AH D IY
WALK	W AO K
WALK(2)	W AA K
ROAD	R OW D
ALONE	AH L OW N
ONE'S	W AH N Z
FAULT	F AO L T
PATH	P AE TH
CHOSEN	CH OW Z AH N
FROZEN	F R OW Z AH N
SNOW	S N OW
EMOTION	IH M OW SH AH N
EMOTION(2)	IY M OW SH AH N
WHATSOEVER	W AH T S OW EH V ER
WHATSOEVER(2)	HH W AH T S OW EH V ER
ASK	AE S K
WHY	W AY
WHY(2)	HH W AY
MO'FUCKIN'	M AA F AH K AH N
BLOODSUCKING	B L AH D S AH K IH NG
SUCCUBUSES	S AH K Y UW B Y UW Z AH Z
TRIED	T R AY D
DEPARTMENT	D IH P AA R T M AH N T
AIN'T	EY N T
LUCK	L AH K
SUCKS	S AH K S
EXACTLY	IH G Z AE K T L IY
THOUGHT	TH AO T
TRYIN'	T R AY IH N
START	S T AA R T
HEART	HH AA R T
SOME	S AH M
KIND	K AY N D
EMOTIONAL	IH M OW SH AH N AH L
EMOTIONAL(2)	IY M OW SH AH N AH L
ROLLER-COASTER	R OW L ER K OW S T ER
SOMETHIN'	S AH M TH IH N
TIL'	T IH L
TOY	T OY
EMOTIONS	IH M OW SH AH N Z
AN	AE N
AN(2)	AH N
EXPLOSION	IH K S P L OW ZH AH N
EVERY	EH V ER IY
EVERY(2)	EH V R IY
TIME	T AY M
WASN'T	W AA Z AH N T
WASN'T(2)	W AH Z AH N T
JOKIN'	JH AA K AH N
TAKE	T EY K
BREATH	B R EH TH
AWAY	AH W EY
YOU'RE	Y UH R
YOU'RE(2)	Y UW R
SUPERNOVA	S UW P ER N OW V AH
SPACE-BOUND	S P EY S B AW N D
ROCKETSHIP	R AA K AH T SH IH P
HEART'S	HH AA R T S
MOON	M UW N
AIMIN'	EY M AH N
AT	AE T
TWO	T UW
HUNDRED	HH AH N D R AH D
HUNDRED(2)	HH AH N D R IH D
HUNDRED(3)	HH AH N ER D
HUNDRED(4)	HH AH N D ER D
FIFTY	F IH F T IY
THOUSAND	TH AW Z AH N D
THOUSAND(2)	TH AW Z AH N
MILES	M AY L Z
MILES(2)	M AY AH L Z
CLEAR	K L IH R
NIGHT	N AY T
JUNE	JH UW N
WHATEVER	W AH T EH V ER
WHATEVER(2)	HH W AH T EH V ER
TAKES	T EY K S
SHAKES	SH EY K S
BODY	B AA D IY
ACHES	EY K S
ZERO	Z IY R OW
STRENGTH	S T R EH NG K TH
STRENGTH(2)	S T R EH NG TH
LIMIT	L IH M AH T
FAR	F AA R
BOUNDARIES	B AW N D ER IY Z
BOUNDARIES(2)	B AW N D R IY Z
LENGTHS	L EH NG K TH S
LENGTHS(2)	L EH NG TH S
SAY	S EY
UNTIL	AH N T IH L
PERSON	P ER S AH N
THINK'S	TH IH NG K S
GONNA	G AA N AH
THEN	DH EH N
'EM	AH M
SAME	S EY M
SOON	S UW N
FEELINGS	F IY L IH NG Z
CONTEST	K AA N T EH S T
CONTEST(2)	K AH N T EH S T
CONQUEST	K AA NG K W EH S T
MATE	M EY T
LOOKIN'	L UH K IH N
STUMBLED	S T AH M B AH L D
ONTO	AA N T UW
ONTO(2)	AO N T UW
MUST'VE	M AH S T IH V
FATE	F EY T
STAKE	S T EY K
DOES	D AH Z
DOES(2)	D IH Z
LET'S	L EH T S
CUT	K AH T
CHASE	CH EY S
'FORE	F AO R
DOOR	D AO R
SHUTS	SH AH T S
FACE	F EY S
PROMISE	P R AA M AH S
CAVE	K EY V
BREAK	B R EY K
LEAVE	L IY V
MYSELF	M AY S EH L F
OPEN	OW P AH N
MAKIN'	M EY K IH N
MISTAKE	M IH S T EY K
250	T UW F AY V Z IY R OW
000	Z IY R OW Z IY R OW Z IY R OW
AFTER	AE F T ER
YEAR	Y IH R
6	S IH K S
MONTHS	M AH N TH S
LONGER	L AO NG G ER
HURTS	HH ER T S
MISTREATED	M IH S T R IY T IH D
POUR	P AO R
GUARD	G AA R D
SWEAR	S W EH R
BRAINS	B R EY N Z
LAP	L AE P
LAY	L EY
DIE	D AY
PLEADIN'	P L IY D AH N
STOP	S T AA P
LEAVIN'	L IY V AH N
LISTEN	L IH S AH N
BREATHIN'	B R IY TH AH N
PUT	P UH T
BOTH	B OW TH
HANDS	HH AE N D Z
HANDS(2)	HH AE N Z
THROAT	TH R OW T
SIT	S IH T
TOP	T AA P
TOP(2)	T AO P
SQUEEZIN'	S K W IY Z AH N
NECK	N EH K
POPSICLE	P AA P S IH K AH L
STICK	S T IH K
POSSIBLE	P AA S AH B AH L
REASON	R IY Z AH N
THINK	TH IH NG K
HOUSE	HH AW S
LIVE	L AY V
LIVE(2)	L IH V
TEARS	T EH R Z
TEARS(2)	T IH R Z
STREAM	S T R IY M
CHEEKS	CH IY K S
GUN	G AH N
TEMPLE	T EH M P AH L
WOULD'VE	W UH D AH V
ADORED	AH D AO R D
LATE	L EY T
SAVE	S EY V
OUR	AW ER
OUR(2)	AW R
OUR(3)	AA R
YOU'LL	Y UW L
SKY	S K AY
SEE	S IY
STAR	S T AA R
'CUZ	K AH Z
LOST	L AO S T
WITHOUT	W IH TH AW T
WITHOUT(2)	W IH DH AW T
STAND	S T AE N D
WATCH	W AA CH
WATCH(2)	W AO CH
BURN	B ER N
ALRIGHT	AO L R AY T
BECAUSE	B IH K AO Z
BECAUSE(2)	B IH K AH Z
BECAUSE(3)	B IH K AA Z
WAY	W EY
HEAR	HH IY R
CRY	K R AY
LIE	L AY
TELL	T EH L
REALLY	R IH L IY
REALLY(2)	R IY L IY
FEELS	F IY L Z
STEEL	S T IY L
KNIFE	N AY F
WINDPIPE	W IH N D P AY P
BREATHE	B R IY DH
STILL	S T IH L
FIGHT	F AY T
WHILE	W AY L
WHILE(2)	HH W AY L
LONG	L AO NG
WRONG	R AO NG
FLIGHT	F L AY T
HIGH	HH AY
DRUNK	D R AH NG K
HATE	HH EY T
HUFFING	HH AH F IH NG
PAINT	P EY N T
SUFFER	S AH F ER
SUFFOCATE	S AH F AH K EY T
IM	IH M
ABOUT	AH B AW T
DROWN	D R AW N
SHE	SH IY
RESUSCITATES	R AH S AH S AH T EY T S
FUCKING	F AH K IH NG
HATES	HH EY T S
WAIT	W EY T
WHERE	W EH R
WHERE(2)	HH W EH R
GOING	G OW IH NG
GOING(2)	G OW IH N
LEAVING	L IY V IH NG
WE'RE	W IY R
WE'RE(2)	W IH R
WE'RE(3)	W ER
RUNNING	R AH N IH NG
INSANE	IH N S EY N
CAUSE	K AA Z
CAUSE(2)	K AO Z
GOOD	G UH D
GOOD(2)	G IH D
GREAT	G R EY T
SUPERMAN	S UW P ER M AH N
SUPERMAN(2)	S UW P ER M AE N
WIND	W AY N D
WIND(2)	W IH N D
SHE'S	SH IY Z
LOIS	L OW AH S
LANE	L EY N
BAD	B AE D
AWFUL	AA F AH L
AWFUL(2)	AO F AH L
ASHAMED	AH SH EY M D
WHO'S	HH UW Z
DUDE	D UW D
NAME	N EY M
LAID	L EY D
HER	HH ER
STOOP	S T UW P
LOW	L OW
GUESS	G EH S
SOMEBODY	S AH M B AA D IY
SOMEBODY(2)	S AH M B AH D IY
THEM	DH EH M
THEM(2)	DH AH M
MEET	M IY T
NEITHER	N IY DH ER
NEITHER(2)	N AY DH ER
HIT	HH IH T
WARM	W AO R M
FUZZY	F AH Z IY
FEELING	F IY L IH NG
YEAH	Y AE
CHILLS	CH IH L Z
USED	Y UW Z D
SICK	S IH K
LOOKING	L UH K IH NG
SWORE	S W AO R
YOU'VE	Y UW V
NOTHING	N AH TH IH NG
EACH	IY CH
OTHER'S	AH DH ER Z
SPEWING	S P Y UW IH NG
VENOM	V EH N AH M
PUSH	P UH SH
PULL	P UH L
HAIR	HH EH R
SCRATCH	S K R AE CH
CLAW	K L AO
BIT	B IH T
THROW	TH R OW
PIN	P IH N
MOMENTS	M OW M AH N T S
TOOK	T UH K
CONTROLS	K AH N T R OW L Z
SEPARATE	S EH P ER EY T
SEPARATE(2)	S EH P ER IH T
SEPARATE(3)	S EH P R AH T
WAYS	W EY Z
TODAY	T AH D EY
TODAY(2)	T UW D EY
YESTERDAY	Y EH S T ER D EY
YESTERDAY(2)	Y EH S T ER D IY
DIFFERENT	D IH F ER AH N T
DIFFERENT(2)	D IH F R AH N T
DAY	D EY
SOUND	S AW N D
BROKEN	B R OW K AH N
RECORDS	R AH K AO R D Z
RECORDS(2)	R EH K ER D Z
RECORDS(3)	R IH K AO R D Z
PLAYIN'	P L EY IH N
PROMISED	P R AA M AH S T
RESTRAINT	R IH S T R EY N T
RESTRAINT(2)	R IY S T R EY N T
NINTENDO	N IH N T EH N D OW
GAME	G EY M
LIED	L AY D
WINDOW	W IH N D OW
PANE	P EY N
SAID	S EH D
THINGS	TH IH NG Z
DIDN'T	D IH D AH N T
DIDN'T(2)	D IH D N T
DIDN'T(3)	D IH D AH N
DIDN'T(4)	D IH N T
MEAN	M IY N
FALL	F AO L
FALL(2)	F AA L
INTO	IH N T UW
INTO(2)	IH N T AH
PATTERNS	P AE T ER N Z
ROUTINE	R UW T IY N
TEMPER'S	T EH M P ER Z
BLINDED	B L AY N D IH D
PLEASE	P L IY Z
MAYBE	M EY B IY
RELATIONSHIP	R IY L EY SH AH N SH IH P
CRAZY	K R EY Z IY
SEEMS	S IY M Z
HAPPENS	HH AE P AH N Z
TORNADO	T AO R N EY D OW
MEETS	M IY T S
VOLCANO	V AA L K EY N OW
THOUGH	DH OW
PICK	P IH K
BAGS	B AE G Z
SIDEWALK	S AY D W AO K
SINCERITY	S IH N S EH R AH T IY
VOICE	V OY S
TALK	T AO K
EYEBALL	AY B AO L
PISSED	P IH S T
AIM	EY M
FIST	F IH S T
DRY	D R AY
WALL	W AO L
WILL	W IH L
WILL(2)	W AH L
APOLOGIZE	AH P AA L AH JH AY Z
LIES	L AY Z
TIRED	T AY ER D
LIAR	L AY ER
TRIES	T R AY Z
I'MMA	IH M AH
TIE	T AY
BED	B EH D
FIRE	F AY ER
FIRE(2)	F AY R
AFRAID	AH F R EY D
EVERYBODY	EH V R IY B AA D IY
HAND	HH AE N D
WE'LL	W IY L
WE'LL(2)	W IH L
TOGETHER	T AH G EH DH ER
STORM	S T AO R M
WEATHER	W EH DH ER
LETTING	L EH T IH NG
HOLLER	HH AA L ER
RIDE	R AY D
PLACE	P L EY S
MIGHT	M AY T
TRYING	T R AY IH NG
TRYING(2)	T R AY NG
FOLLOW	F AA L OW
TRY	T R AY
READ	R EH D
READ(2)	R IY D
LYRICS	L IH R IH K S
PAPER	P EY P ER
STING	S T IH NG
CAUSING	K AA Z IH NG
CAUSING(2)	K AO Z IH NG
MAYHEM	M EY HH EH M
SOMETHING	S AH M TH IH NG
DAMN	D AE M
DOING	D UW IH NG
BEANS	B IY N Z
GASSED	G AE S T
THINKS	TH IH NG K S
STOPPING	S T AA P IH NG
DOUBT	D AW T
UNDOUBTEDLY	AH N D AW T IH D L IY
THOSE	DH OW Z
TEARING	T EH R IH NG
TEARING(2)	T IH R IH NG
BALCONY	B AE L K AH N IY
IFS	IH F S
ANDS	AE N D Z
BUTS	B AH T S
INFINITE	IH N F AH N AH T
LAST	L AE S T
RELAPSE	R IY L AE P S
ALBUM	AE L B AH M
SHITTING	SH IH T IH NG
WHETHER	W EH DH ER
WHETHER(2)	HH W EH DH ER
SALARY	S AE L ER IY
PAID	P EY D
HOURLY	AW R L IY
BOWS	B AW Z
BOWS(2)	B OW Z
SHITS	SH IH T
BOWELS	B AW AH L Z
BOWELS(2)	B AW L Z
WHICHEVER	W IH CH EH V ER
WHICHEVER(2)	HH W IH CH EH V ER
FIRST	F ER S T
WORSE	W ER S
MARRIED	M EH R IY D
CHRISTMAS	K R IH S M AH S
GIFT	G IH F T
CURSE	K ER S
FORGET	F ER G EH T
FORGET(2)	F AO R G EH T
EARTH	ER TH
URGE	ER JH
DICK	D IH K
UNIVERSE	Y UW N AH V ER S
OKAY	OW K EY
QUIT	K W IH T
PLAYING	P L EY IH NG
SCISSORS	S IH Z ER Z
SHIT	SH IH T
CRAP	K R AE P
SHOULDN'T	SH UH D AH N T
RHYME	R AY M
RHYTHM	R IH DH AH M
RAP	R AE P
TEETH	T IY TH
FILLINGS	F IH L IH NG Z
INSTEAD	IH N S T EH D
CROWNED	K R AW N D
CAPPED	K AE P T
FANS	F AE N Z
HONEST	AA N AH S T
CD	S IY D IY
EHHH	EH HH
PERHAPS	P ER HH AE P S
RAN	R AE N
ACCENTS	AE K S EH N T S
GROUND	G R AW N D
RELAX	R IH L AE K S
RELAX(2)	R IY L AE K S
CLICK-CLACK	K L IH K K L AE K
AROUND	ER AW N D
AROUND(2)	ER AW N
CALLED	K AO L D
CIRCLE	S ER K AH L
FIGURE	F IH G Y ER
MAPPED	M AE P T
BLACK	B L AE K
CLOUD	K L AW D
FOLLOWS	F AA L OW Z
EXORCISE	EH K S AO R S AY Z
DEMONS	D IY M AH N Z
MOTHERFUCKERS	M AH DH ER F AH K ER Z
JUMPING	JH AH M P IH NG
JACKS	JH AE K S
KEEP	K IY P
LIVING	L IH V IH NG
STARTING	S T AA R T IH NG
BREAKING	B R EY K IH NG
CAGE	K EY JH
STANDING	S T AE N D IH NG
MANNING	M AE N IH NG
FED	F EH D
DECISION	D IH S IH ZH AH N
CLEAN	K L IY N
ADMITTEDLY	AE D M IH T IH D L IY
PROBABLY	P R AA B AH B L IY
SUBLIMINALLY	S AH B L IH M IH N AH L IY
COULD	K UH D
BRAND	B R AE N D
HELPED	HH EH L P T
REALIZE	R IY AH L AY Z
RINGER	R IH NG ER
LITTLE	L IH T AH L
MIDDLE	M IH D AH L
FINGER	F IH NG G ER
EYE	AY
HATERS	HH EY T ER Z
BEES	B IY Z
STINGERS	S T IH NG ER Z
DEAD	D EH D
BEEF	B IY F
LINGERS	L IH NG G ER Z
DRAMA	D R AA M AH
FOCUS	F OW K AH S
FOCUS(2)	F OW K IH S
SOLELY	S OW AH L IY
HANDLING	HH AE N D L IH NG
HANDLING(2)	HH AE N D AH L IH NG
RESPONSIBILITIES	R IY S P AA N S AH B IH L AH T IY Z
SOLEMNLY	S AO L AH M L IY
ALWAYS	AO L W EY Z
ALWAYS(2)	AO L W IY Z
TREAT	T R IY T
DAUGHTERS	D AO T ER Z
RAISE	R EY Z
COULDN'T	K UH D AH N T
COULDN'T(2)	K UH D AH N
LIFT	L IH F T
SINGLE	S IH NG G AH L
SHINGLE	SH IH NG G AH L
STRONG	S T R AO NG
CLUB	K L AH B
CORNER	K AO R N ER
PUB	P AH B
LIQUOR	L IH K ER
COUNTER	K AW N T ER
RAISING	R EY Z IH NG
BAR	B AA R
I'D	AY D
SHOOT	SH UW T
BUSY	B IH Z IY
GAZING	G EY Z IH NG
STARS	S T AA R Z
AMAZING	AH M EY Z IH NG
FRIENDS	F R EH N D Z
MONSTER	M AA N S T ER
UNDER	AH N D ER
ALONG	AH L AO NG
VOICES	V OY S AH Z
VOICES(2)	V OY S IH Z
HEAD	HH EH D
HOLDIN'	HH OW L D IH N Z
FAME	F EY M
COVER	K AH V ER
NEWSWEEK	N UW Z W IY K
WELL	W EH L
BEGGARS	B EH G ER Z
CHOOSEY	CH UW Z IY
RECEIVE	R AH S IY V
RECEIVE(2)	R IH S IY V
RECEIVE(3)	R IY S IY V
ATTENTION	AH T EH N SH AH N
LEFT	L EH F T
PUBLIC	P AH B L IH K
EXCUSE	IH K S K Y UW S
EXCUSE(2)	IH K S K Y UW Z
WANTIN	W AA N T IH N
CAKE	K EY K
EAT	IY T
MADE	M EY D
BALLOON	B AH L UW N
EGO	IY G OW
INFLATED	IH N F L EY T IH D
BLEW	B L UW
CONFUSING	K AH N F Y UW Z IH NG
DO'S	D UW Z
BRUCE	B R UW S
LEE	L IY
LOOSE	L UW S
LEAF	L IY F
ABUSED	AH B Y UW Z D
INK	IH NG K
TOOL	T UW L
STEAM	S T IY M
OOH	UW
LOTTERY	L AA T ER IY
WEE	W IY
GAVE	G EY V
BITTERSWEET	B IH T ER S W IY T
WINNIN'	W IH N AH N
MINK	M IH NG K
IRONIC	AY R AA N IH K
GETTIN'	G IH T AH N
HUGE	HH Y UW JH
HUGE(2)	Y UW JH
NEED	N IY D
SHRINK	SH R IH NG K
BEGINNING	B IH G IH N IH NG
SLEEP	S L IY P
SHEEP	SH IY P
CUCKOO	K AH K UW
CUCKOO(2)	K UW K UW
COOKY	K UH K IY
KOOL	K UW L
KEITH	K IY TH
ACTUALLY	AE K CH UW AH L IY
ACTUALLY(2)	AE K CH L IY
ACTUALLY(3)	AE K SH AH L IY
WEIRDER	W IH R D ER
THAN	DH AE N
THAN(2)	DH AH N
FAIR	F EH R
POET	P OW AH T
SQUANDER	S K W AA N D ER
TOMORROW	T AH M AA R OW
TOMORROW(2)	T UW M AA R OW
CONJURIN'	K AA N JH UH R AH N
SOMETIMES	S AH M T AY M Z
THOUGHTS	TH AO T S
SPAWN	S P AA N
SPAWN(2)	S P AO N
PONDERIN'LL	P AA N D ER IH N L
WANDERS	W AA N D ER Z
LOSING	L UW Z IH NG
YODEL-ODEL-AY-HEE-HOO	Y OW D AH L AA D AH L EY HH IY HH UW
WANDERIN'	W AA N D AH R AH N
YONDER	Y AA N D ER
JEFF	JH EH F
VANVONDEREN	V AE N V AA N D AH R AH N
INTERVENTIONIST	IH N T ER V EH N SH AH N IH S T
INTERVENE	IH N T ER V IY N
CONFLICT	K AA N F L IH K T
CONFLICT(2)	K AH N F L IH K T
VERY	V EH R IY
THING	TH IH NG
LOVE'S	L AH V Z
KILLIN'	K IH L IH N
CONQUER	K AA NG K ER
OCD	AA K D
CONKIN'	K AA NG K IH N
KNOCKIN'	N AA K AH N
NOBODY'S	N OW B AA D IY Z
NOBODY'S(2)	N OW B AH D IY Z
SLEEPWALKIN'	S L IY P W AA L K AH N
RELAYIN'	R AH L EY AH N
HEAD'S	HH EH D Z
SAYIN'	S EY IH N
MESSENGER	M EH S AH N JH ER
MESSENGER(2)	M EH S IH N JH ER
VISION	V IH ZH AH N
AMONGST	AH M AH NG S T
REGULAR	R EH G Y AH L ER
REGULAR(2)	R EY G Y AH L ER
CIVILIAN	S AH V IH L Y AH N
DRUMS	D R AH M Z
KILLED	K IH L D
COMIN'	K AH M IH N
STRAIGHT	S T R EY T
MC'S	M IH K S
BLOOD	B L AH D
SPILLED	S P IH L D
DAYS	D EY Z
DRE	D AH R
TRACK	T R AE K
KID	K IH D
PLAYED	P L EY D
PUMPED	P AH M P T
FEELIN'	F IY L IH N
KIDS	K IH D Z
FUCKIN'	F AH K AH N
CHILDREN	CH IH L D R AH N
MILLION	M IH L Y AH N
GOIN'	G OW AH N
STRUGGLE	S T R AH G AH L
RELATES	R IH L EY T S
RELATES(2)	R IY L EY T S
PAYBACK	P EY B AE K
RUSSELL	R AH S AH L
WILSON	W IH L S AH N
FALLIN'	F AE L IH N
DRAFT	D R AE F T
TURN	T ER N
NOTHIN'	N AH TH IH N
STRAW	S T R AO
GOLD	G OW L D
CHUMP	CH AH M P
SPIN	S P IH N
RUMPELSTILTSKIN	R AH M P AH L S T IH L T S AH N
HAYSTACK	HH EY S T AE K
JACKET	JH AE K AH T
JACKET(2)	JH AE K IH T
FACTS	F AE K T S
FACTS(2)	F AE K S
AM	AE M
AM(2)	EY EH M
NUTS	N AH T S
REAL	R IY L
LOVED	L AH V D
SOMEONE	S AH M W AH N
YOU'D	Y UW D
YOU'D(2)	Y UH D
ARM	AA R M
EXPRESSION	IH K S P R EH SH AH N
LITERALLY	L IH T ER AH L IY
LITERALLY(2)	L IH T R AH L IY
THEY'RE	DH EH R
WERE	W ER
THEIR	DH EH R
ARMOUR	AA R M ER
DESTROY	D IH S T R OY
ANYONE	EH N IY W AH N
HARM	HH AA R M
KARMA	K AA R M AH
TURNS	T ER N Z
BITES	B AY T S
SPITE	S P AY T
BECOME	B IH K AH M
MAIN	M EY N
SOURCE	S AO R S
DADDY	D AE D IY
DAD'S	D AE D Z
GOTTA	G AA T AH
CATCH	K AE CH
PLANE	P L EY N
WHERE'S	W EH R Z
WHERE'S(2)	HH W EH R Z
MOMMY	M AA M IY
FIND	F AY N D
HAILIE	HH EY L IY
DADDY'S	D AE D IY Z
WRITING	R AY T IH NG
SONG	S AO NG
WRITE	R AY T
ITSELF	IH T S EH L F
UNDERDOG	AH N D ER D AO G
SWING	S W IH NG
MOTHER	M AH DH ER
SPITTING	S P IH T IH NG
IMAGE	IH M AH JH
IMAGE(2)	IH M IH JH
SLIM	S L IH M
SHADY	SH EY D IY
SHADY'S	SH EY D IY Z
TONIGHT	T AH N AY T
TONIGHT(2)	T UW N AY T
ROCKA-BY-BABY	R AA K AH B AY B EY B IY
GONE	G AO N
CARRY	K AE R IY
CARRY(2)	K EH R IY
MOURN	M AO R N
REJOICE	R IH JH OY S
SMILING	S M AY L IH NG
SMILE	S M AY L
HAVING	HH AE V IH NG
DREAM	D R IY M
PUSHIN'	P AH SH AH N
SCREAMING	S K R IY M IH NG
SING	S IH NG
MAKING	M EY K IH NG
CRYING	K R AY IH NG
LYING	L AY IH NG
PILING	P AY L IH NG
BOXES	B AA K S AH Z
BOXES(2)	B AA K S IH Z
FRONT	F R AH N T
BLOCK	B L AA K
-	
POCKET	P AA K AH T
PULLS	P UH L Z
TINY	T AY N IY
NECKLACE	N EH K L AH S
LOCKET	L AA K IH T
PICTURE	P IH K CH ER
THIS'LL	DH IH S AH L
SAFE	S EY F
WITHCHA'	W IH TH AH
MIRROR	M IH R ER
WALLS	W AO L Z
TALKING	T AO K IH NG
SAYING	S EY IH NG
BEDROOM	B EH D R UW M
SPOTLIGHT	S P AA T L AY T
SINGING	S IH NG IH NG
SIXTY	S IH K S T IY
PEOPLE	P IY P AH L
SEAT	S IY T
CURTAIN	K ER T AH N
CLOSES	K L OW Z IH Z
THROWING	TH R OW IH NG
ROSES	R OW Z IH Z
BOW	B AW
BOW(2)	B OW
THANK	TH AE NG K
COMING	K AH M IH NG
GLANCE	G L AE N S
SEEING	S IY IH NG
HELP	HH EH L P
WRISTS	R IH S T S
BLEEDING	B L IY D IH NG
SWEDEN	S W IY D AH N
FOLLOWED	F AA L OW D
WEREN'T	W ER AH N T
WEREN'T(2)	W ER N T
DAD	D AE D
SAD	S AE D
BOUGHT	B AA T
BOUGHT(2)	B AO T
COIN	K OY N
SAYS	S EH Z
SAYS(2)	S IH Z
'NUMBER	N AH M AH R
DAD'	D AE D
FINE	F AY N
CHOICE	CH OY S
MARSHALL	M AA R SH AH L
SCREAMIN'	S K R IY M AH N
PILL	P IH L
BET	B EH T
WORD	W ER D
K-KEEP	K EY K IY P
APPLAUSE	AH P L AO Z
CLOSING	K L OW Z IH NG
COCK	K AA K
BRAIN	B R EY N
SCREAM	S K R IY M
POP	P AA P
DARKENS	D AA R K AH N Z
FLASHES	F L AE SH IH Z
SUPPOSED	S AH P OW Z D
CRASHES	K R AE SH IH Z
BURNS	B ER N Z
ASHES	AE SH IH Z
WAKE	W EY K
ALARM	AH L AA R M
RINGIN'	R IH N JH AH N
BIRDS	B ER D Z
SINGIN'	S IH NG IH N
SPRING	S P R IH NG
SPRING(2)	S P ER IH NG
HAILIE'S	HH EY L IY Z
OUTSIDE	AW T S AY D
SWINGING	S W IH NG IH NG
KIM	K IH M
KISS	K IH S
SMILES	S M AY L Z
WINKS	W IH NG K S
SISTER	S IH S T ER
ALMOST	AO L M OW S T
FELL	F EH L
ROSE	R OW Z
CLAIM	K L EY M
DARK	D AA R K
KISSED	K IH S T
LIPS	L IH P S
SAVED	S EY V D
FALLING	F AA L IH NG
SIDE	S AY D
KNEW	N UW
KNEW(2)	N Y UW
TRUE	T R UW
WIN	W IH N
RAIN	R EY N
WATCHED	W AA CH T
WATCHED(2)	W AO CH T
TOUCHED	T AH CH T
BURNED	B ER N D
CRIED	K R AY D
HEARD	HH ER D
EYES	AY Z
FOREVER	F ER EH V ER
THREW	TH R UW
FLAMES	F L EY M Z
WAITING	W EY T IH NG
OOOOOOH	UW UW UW
NOO	N UW
SETTLED	S EH T AH L D
FOUND	F AW N D
GIRL	G ER L
DREAMS	D R IY M Z
CAME	K EY M
FRIEND	F R EH N D
SHY	SH AY
HIDE	HH AY D
LIGHT	L AY T
BLUE	B L UW
UNINVITED	AH N IH N V AY T IH D
HOPED	HH OW P T
REMINDED	R IY M AY N D AH D
REMINDED(2)	R IY M AY N D IH D
WISH	W IH SH
BEG	B EH G
REMEMBER	R IH M EH M B ER
REMEMBER(2)	R IY M EH M B ER
LASTS	L AE S T S
FLIES	F L AY Z
LIVES	L IH V Z
LIVES(2)	L AY V Z
BORN	B AO R N
RAISED	R EY Z D
SUMMER	S AH M ER
HAZE	HH EY Z
BOUND	B AW N D
SURPRISE	S ER P R AY Z
SURPRISE(2)	S AH P R AY Z
GLORY	G L AO R IY
COMPARES	K AH M P EH R Z
WORRIES	W ER IY Z
CARES	K EH R Z
REGRETS	R IH G R EH T S
MISTAKES	M IH S T EY K S
MEMORIES	M EH M ER IY Z
KNOWN	N OW N
TASTE	T EY S T
REACHING	R IY CH IH NG
FEVER	F IY V ER
PITCH	P IH CH
BRINGING	B R IH NG IH NG
FINALLY	F AY N AH L IY
CRYSTAL	K R IH S T AH L
AHEAD	AH HH EH D
SELL	S EH L
SHIP	SH IH P
BARE	B EH R
PIECE	P IY S
UNDERESTIMATE	AH N D ER EH S T AH M EY T
UNDERESTIMATE(2)	AH N D ER EH S T AH M AH T
SCARS	S K AA R Z
REMIND	R IY M AY N D
THINKING	TH IH NG K IH NG
BREATHLESS	B R EH TH L AH S
MET	M EH T
ROLLING	R OW L IH NG
DEEP	D IY P
STORY	S T AO R IY
DEPTHS	D EH P TH S
DESPAIR	D IH S P EH R
SURE	SH UH R
SHARED	SH EH R D
BEATING	B IY T IH NG
SOUL	S OW L
COUNT	K AW N T
BLESSINGS	B L EH S IH NG Z
SORROW	S AA R OW
TREASURED	T R EH ZH ER D
PAY	P EY
REAP	R IY P
SOW	S AW
SOW(2)	S OW
TWICE	T W AY S
DUG	D AH G
DECISIONS	D IH S IH ZH AH N Z
WELCOME	W EH L K AH M
SILLY	S IH L IY
MISPLACED	M IH S P L EY S T
MISUNDERSTOOD	M IH S AH N D ER S T UH D
'NO	N OW
GOOD'	G UH D
GOOD'(2)	G IH D
SLOW	S L OW
MISTAKEN	M IH S T EY K AH N
SECOND	S EH K AH N D
GUESSING	G EH S IH NG
UNDERESTIMATED	AH N D ER EH S T AH M EY T IH D
PRETTY	P R IH T IY
LESS	L EH S
PERFECT	P ER F EH K T
PERFECT(2)	P ER F IH K T
COMPLICATED	K AA M P L AH K EY T AH D
HAPPY	HH AE P IY
FILLED	F IH L D
HATRED	HH EY T R AH D
SUCH	S AH CH
DONE	D AH N
CHASED	CH EY S T
SEEN	S IY N
WORLD'S	W ER L D Z
SCARED	S K EH R D
SWALLOW	S W AA L OW
SWALLOW(2)	S W AO L OW
FEAR	F IH R
SHOULD	SH UH D
DRINKING	D R IH NG K IH NG
ICE	AY S
BEER	B IH R
COOL	K UW L
WASTE	W EY S T
CRITICS	K R IH T IH K S
EVERYWHERE	EH V R IY W EH R
EVERYWHERE(2)	EH V R IY HH W EH R
JEANS	JH IY N Z
EXCHANGE	IH K S CH EY N JH
OURSELVES	AW ER S EH L V Z
OURSELVES(2)	AA R S EH L V Z
MISTY	M IH S T IY
MOUNTAIN	M AW N T AH N
BELOW	B IH L OW
BELOW(2)	B IY L OW
CAREFUL	K EH R F AH L
BROTHERS'	B R AH DH ER Z
SOULS	S OW L Z
SMOKE	S M OW K
WATCHING	W AA CH IH NG
DURIN'S	D Y UH R AH N Z
SONS	S AH N Z
CLIMB	K L AY M
CALLING	K AO L IH NG
AUBURN	AA B ER N
GLASS	G L AE S
WINE	W AY N
PREPARE	P R IY P EH R
MOUNTAINSIDE	M AW N T AH N S AY D
DESOLATION	D EH S AH L EY SH AH N
UPON	AH P AA N
BURNING	B ER N IH NG
TREES	T R IY Z
HOLLOWING	HH AA L OW IH NG
BREEZE	B R IY Z
SURELY	SH UH R L IY
CONFINED	K AH N F AY N D
HALLS	HH AO L Z
FLAME	F L EY M
FAST	F AE S T
RETURNS	R IH T ER N Z
RETURNS(2)	R IY T ER N Z
BROTHERS	B R AH DH ER Z
CRASHED	K R AE SH T
TOWN	T AW N
SHADOW	SH AE D OW
SAW	S AO
CITY	S IH T IY
HEAT	HH IY T
SKIN	S K IH N
YEARS	Y IH R Z
AGO	AH G OW
CAUTION	K AA SH AH N
CAUTION(2)	K AO SH AH N
ILLUSION	IH L UW ZH AH N
CARELESS	K EH R L EH S
FORGOT	F ER G AA T
FORGOT(2)	F AO R G AA T
EFFORTLESSLY	EH F ER T L AH S L IY
WON	W AH N
WON(2)	W AA N
SHOUT	SH AW T
TOPS	T AA P S
LINE	L AY N
BETRAYAL	B IH T R EY AH L
WORST	W ER S T
HEARTS	HH AA R T S
BUILDING	B IH L D IH NG
FAITH	F EY TH
EMPTY	EH M P T IY
EMPTY(2)	EH M T IY
PROMISES	P R AA M AH S AH Z
WEAR	W EH R
EMBARRASSING	IH M B EH R AH S IH NG
CYCLE	S AY K AH L
REPEATED	R IH P IY T IH D
REPEATED(2)	R IY P IY T AH D
REPEATED(3)	R IY P IY T IH D
EXPLOSIONS	IH K S P L OW ZH AH N Z
NEEDED	N IY D AH D
NEEDED(2)	N IY D IH D
COLORS	K AH L ER Z
CONFLICTED	K AH N F L IH K T IH D
CLIMBED	K L AY M D
CLOUDS	K L AW D Z
FIX	F IH K S
GLOW	G L OW
YES	Y EH S
HELD	HH EH L D
BELIEVED	B IH L IY V D
SOLDIER	S OW L JH ER
STRUCK	S T R AH K
RING	R IH NG
CROWN	K R AW N
BUILT	B IH L T
FAN	F AE N
BLAZES	B L EY Z IH Z
TROUBLE	T R AH B AH L
WIDE	W AY D
TOSSED	T AO S T
TRASH	T R AE SH
ASKED	AE S K T
ASKED(2)	AE S T
UNDERSTAND	AH N D ER S T AE N D
GRENADE	G R AH N EY D
BLADE	B L EY D
JUMP	JH AH M P
TRAIN	T R EY N
BULLET	B UH L AH T
TILL	T IH L
NUMB	N AH M
DEVIL	D EH V AH L
'HEY'	HH EY
WOMAN	W UH M AH N
RIP	R IH P
BRAKES	B R EY K S
CAR	K AA R
DARLING	D AA R L IH NG
WOULDN'T	W UH D AH N T
TRUSTING	T R AH S T IH NG
ELSE	EH L S
MATTERS	M AE T ER Z
OPENED	OW P AH N D
OURS	AW ER Z
OURS(2)	AA R Z
OURS(3)	AW R Z
SEEK	S IY K
VIEW	V Y UW
CARED	K EH R D
SOLO	S OW L OW
HETFIELD	HH EH T IY L D
FELT	F EH L T
COMPANY	K AH M P AH N IY
ACHE	EY K
ADDICTED	AH D IH K T IH D
CERTAIN	S ER T AH N
SADNESS	S AE D N AH S
RESIGNATION	R EH Z AH G N EY SH AH N
RESIGNATION(2)	R EH Z IH G N EY SH AH N
SENSE	S EH N S
ADMIT	AH D M IH T
GLAD	G L AE D
HAPPENED	HH AE P AH N D
STRANGER	S T R EY N JH ER
ROUGH	R AH F
COLLECT	K AH L EH K T
NUMBER	N AH M B ER
SCREWED	S K R UW D
BELIEVING	B IH L IY V IH NG
READING	R IY D IH NG
READING(2)	R EH D IH NG
HUNG	HH AH NG
WOAH	W OW AH
JUDA-AS	JH UW D AH AE Z
JUDAS	JH UW D AH S
JUDA-A-A	JH UW D AH EY EY
GA-GA	G AA G AA
CALLS	K AO L Z
ILL	IH L
WASH	W AA SH
NEEDS	N IY D Z
FORGIVE	F ER G IH V
FORGIVE(2)	F AO R G IH V
TONGUE	T AH NG
THREE	TH R IY
BETRAYS	B IH T R EY Z
AH-AH-AHHH-OW	AA AA AE HH OW
UH	AH
O	OW
BRING	B R IH NG
HOLY	HH OW L IY
FOOL	F UW L
HES	HH IY Z
CRUEL	K R UW AH L
CRUEL(2)	K R UW L
COULDNT	K OW AH L D N T
PURELY	P Y UH R L IY
PROPHETS	P R AA F AH T S
FORGAVE	F ER G EY V
GOOFY	G UW F IY
IVE	AY V
LEARNED	L ER N D
LEARNED(2)	L ER N IH D
BRICK	B R IH K
BUILD	B IH L D
SINK	S IH NG K
EW	Y UW
MOST	M OW S T
MOST(2)	M OW S
BIBLICAL	B IH B L AH K AH L
BIBLICAL(2)	B IH B L IH K AH L
BEYOND	B IH AA N D
BEYOND(2)	B IY AO N D
BEYOND(3)	B IH AO N D
REPENTANCE	R IH P EH N T AH N S
HOOKER	HH UH K ER
PROSTITUTE	P R AA S T AH T UW T
WENCH	W EH N CH
VOMITS	V AA M AH T S
CULTURAL	K AH L CH ER AH L
SPEAK	S P IY K
FUTURE	F Y UW CH ER
TENSE	T EH N S
OFFENSED	AH F EH N S T
EAR	IY R
EAR(2)	IH R
CONDOM	K AA N D AH M
SOMETHINGS	S AH M TH IH NG Z
PULLING	P UH L IH NG
JESUS	JH IY Z AH S
VIRTUE	V ER CH UW
DEMON	D IY M AH N
CLING	K L IH NG